-1	-1	-1	-1	-1	-1	-1	-1	-1	-1	-1	-1	-1
-1	-1	-1	-1	-1	-1	-1	-1	-1	-1	-1	-1	-1
-1	-1	-1	-1	1	1	2	1	1	-1	-1	-1	-1
-1	-1	-1	-1	1	3	0	0	1	-1	-1	-1	-1
-1	-1	-1	-1	1	0	0	0	1	-1	-1	-1	-1
-1	-1	-1	-1	1	0	0	0	1	-1	-1	-1	-1
-1	-1	-1	1	1	1	4	1	1	2	-1	-1	-1
-1	-1	-1	1	0	0	0	0	0	1	-1	-1	-1
-1	-1	-1	2	0	0	0	0	0	1	-1	-1	-1
-1	-1	-1	1	0	0	0	0	0	1	-1	-1	-1
-1	-1	-1	1	1	1	1	1	2	1	-1	-1	-1
-1	-1	-1	-1	-1	-1	-1	-1	-1	-1	-1	-1	-1
-1	-1	-1	-1	-1	-1	-1	-1	-1	-1	-1	-1	-1

-1	-1	-1	-1	-1	-1	-1	-1	-1	-1	-1	-1	-1
-1	-1	-1	-1	-1	-1	-1	-1	-1	-1	-1	-1	-1
-1	-1	-1	-1	-1	-1	-1	-1	-1	-1	-1	-1	-1
-1	-1	-1	-1	-1	-1	-1	-1	-1	-1	-1	-1	-1
-1	-1	-1	-1	-1	-1	-1	-1	-1	-1	-1	-1	-1
-1	-1	-1	-1	-1	-1	-1	-1	-1	-1	-1	-1	-1
-1	-1	-1	-1	-1	-1	-1	-1	-1	-1	-1	-1	-1
-1	-1	-1	-1	11	-1	-1	-1	12	-1	-1	-1	-1
-1	-1	-1	-1	-1	-1	10	-1	-1	-1	-1	-1	-1
-1	-1	-1	-1	-1	-1	-1	-1	14	-1	-1	-1	-1
-1	-1	-1	-1	-1	-1	-1	-1	-1	-1	-1	-1	-1
-1	-1	-1	-1	-1	-1	-1	-1	-1	-1	-1	-1	-1
-1	-1	-1	-1	-1	-1	-1	-1	-1	-1	-1	-1	-1