-1	-1	-1	-1	-1	-1	-1	-1	-1	-1	-1	-1	-1
-1	-1	-1	-1	-1	-1	-1	-1	-1	-1	-1	-1	-1
-1	-1	-1	-1	-1	-1	-1	-1	-1	-1	-1	-1	-1
-1	-1	-1	1	1	1	2	1	-1	-1	-1	-1	-1
-1	-1	-1	1	0	3	0	1	1	-1	-1	-1	-1
-1	-1	-1	1	0	0	0	0	1	1	-1	-1	-1
-1	-1	-1	2	0	0	0	0	0	1	-1	-1	-1
-1	-1	-1	1	1	0	0	0	0	1	-1	-1	-1
-1	-1	-1	-1	1	1	0	0	0	1	-1	-1	-1
-1	-1	-1	-1	-1	1	1	1	2	1	-1	-1	-1
-1	-1	-1	-1	-1	-1	-1	-1	-1	-1	-1	-1	-1
-1	-1	-1	-1	-1	-1	-1	-1	-1	-1	-1	-1	-1
-1	-1	-1	-1	-1	-1	-1	-1	-1	-1	-1	-1	-1

-1	-1	-1	-1	-1	-1	-1	-1	-1	-1	-1	-1	-1
-1	-1	-1	-1	-1	-1	-1	-1	-1	-1	-1	-1	-1
-1	-1	-1	-1	-1	-1	-1	-1	-1	-1	-1	-1	-1
-1	-1	-1	-1	-1	-1	-1	-1	-1	-1	-1	-1	-1
-1	-1	-1	-1	-1	-1	-1	-1	-1	-1	-1	-1	-1
-1	-1	-1	-1	-1	13	13	-1	-1	-1	-1	-1	-1
-1	-1	-1	-1	-1	13	-1	-1	10	-1	-1	-1	-1
-1	-1	-1	-1	-1	-1	-1	13	-1	-1	-1	-1	-1
-1	-1	-1	-1	-1	-1	11	-1	-1	-1	-1	-1	-1
-1	-1	-1	-1	-1	-1	-1	-1	-1	-1	-1	-1	-1
-1	-1	-1	-1	-1	-1	-1	-1	-1	-1	-1	-1	-1
-1	-1	-1	-1	-1	-1	-1	-1	-1	-1	-1	-1	-1
-1	-1	-1	-1	-1	-1	-1	-1	-1	-1	-1	-1	-1